6 5
- - s s - -
s s s s s s
s s a a s s
s s s s s s
- - s s - -