5 5
s s s - -
s s s s -
s s z s s
- s s s s
- - s s s