5 5
s s s s s
s s a s s
- s s s -
s s a s s
s s s s s