5 5
s s s - -
s s s - -
s s s s s
- - s s s
- - s s s